NO textures/poolN.xpm
WE textures/poolW.xpm
EA textures/poolE.xpm
SO textures/poolS.xpm

F 220,100,0
C 225,30,0

111111111111111111111
1E0000000000000000001
100000000000111111111
100000000111111111111
100000111110001111111
100111111110001111111
100111111111111111111
100110001111111111111
100110100001111111111
100111100000011111111
100011000000000111111
100000000000000111101
100000000000000111101
100000000000000111101
100000000000011111001
111111111111111111111