NO textures/N.xpm

WE textures/W.xpm


EA textures/E.xpm


SO textures/S.xpm


F 109,109,109


C 135,206,235

111111111111111111111
100111110000000001001
100000000000000000001
100001110000000000001
100000000000000000001
100000000000000000001
100000111111111000001
1000000000N0000000001
111111111111111111111
