NO textures/N.xpm
WE textures/W.xpm
EA textures/E.xpm
SO textures/S.xpm

F 00000,0,0
C 255,0,0


11111111111111111
10000000000000001
10001111111000001
1000000N001000001
10000000001000000111
1000000000100000000111
1000000000100000000000111
100000000010000000000000011
1000000000111111111110000111
100000000011000001100100000011
1000000000110000011000000000001
1000000000000000000000000000001
1000000000000000000000000000001
1111111111111111111111111111111
