NO textures/N.xpm

WE textures/W.xpm


EA textures/E.xpm


SO textures/S.xpm


F 109,109,109


C 135,206,235


1111111111111111111111111
1001111110000001111000001
1000000000000000000111011
1000000000011111110000001
100000000N000000000111011
1000000000000000000000001
1000000111111110000010001
1000000000000000000000001
1111111111111111111111111