NO textures/no.xpm

WE textures/we.xpm


EA textures/ea.xpm


SO textures/so.xpm


F 255,255,255


C 255,0,0




11111111111111111111111111111111111111111111111111111111111111111111111111111111111111111111111111111111111111111111111111111111111
10000000100110001110111000000010000100001000010000100001000010000100001000010000100001000010000100001000010000100001000010000100001
10111110101110011001011011111011110111101111011110111101111011110111101111011110111101111011110111101111011110111101111011110111101
10100010101000011011011010001010010100101001010010100101001010010100101001010010100101001010010100101001010010100101001010010100101
10100010110111101101100010001010010100101001010010100101001010010100101001010010100101001010010100101001010010100101001010010100101
10100010101010001100011010001010010100101001010010100101001010010100101001010010100101001010010100101001010010100101001010010100101
10111110110001001001101011111011110111101111011110111101111011110111101111011110111101111011110111101111011110111101111011110111101
10000000101010101010101000000010000100001000010000100001000010000100001000010000100001000010000100001000010000100001000010000100001
11111111110011100110111110111111111111111111111111111111111111111111111111111111111111111111111111111111111111111111111111111111111
10110000000100000001110110100011000110001100011000110001100011000110001100011000110001100011000110001100011000110001100011000110001
11000101001000100100010100100111001110011100111001110011100111001110011100111001110011100111001110011100111001110011100111001110011
11101100101011100000101100101111011110111101111011110111101111011110111101111011110111101111011110111101111011110111101111011110111
10000101011110101101010001011010110101101011010110101101011010110101101011010110101101011010110101101011010110101101011010110101101
10000010100011000111101001111011110111101111011110111101111011110111101111011110111101111011110111101111011110111101111011110111101
11001101111000110010111000000010000100001000010000100001000010000100001000010000100001000010000100001000010000100001000010000100001
11010010101010100100000010101011010110101101011010110101101011010110101101011010110101101011010110101101011010110101101011010110101
11000111101001100010011100101011010110101101011010110101101011010110101101011010110101101011010110101101011010110101101011010110101
10101000001101111111000111011110111101111011110111101111011110111101111011110111101111011110111101111011110111101111011110111101111
10011111101111110000011110100111001110011100111001110011100111001110011100111001110011100111001110011100111001110011100111001110011
10000010100000000110011110011010110101101011010110101101011010110101101011010110101101011010110101101011010110101101011010110101101
10000011100111010010011011001110011100111001110011100111001110011100111001110011100111001110011100111001110011100111001110011100111
10011000100001011101100000000110001100011000110001100011000110001100011000110001100011000110001100011000110001100011000110001100011
11111111101111011110101110011110111101111011110111101111011110111101111011110111101111011110111101111011110111101111011110111101111
10000000000111010100001010011110111101111011110111101111011110111101111011110111101111011110111101111011110111101111011110111101111
10111110101010010001001110110011100111001110011100111001110011100111001110011100111001110011100111001110011100111001110011100111001
10100010101001010110000000011010110101101011010110101101011010110101101011010110101101011010110101101011010110101101011010110101101
10100010101011000100110111111011110111101111011110111101111011110111101111011110111101111011110111101111011110111101111011110111101
10100010110110110001100100100011000110001100011000110001100011000110001100011000110001100011000110001100011000110001100011000110001
10111110110001001111111001001010010100101001010010100101001010010100101001010010100101001010010100101001010010100101001010010100101
1N000000000000100010001010111111111111111111111111111111111111111111111111111111111111111111111111111111111111111111111111111111111
11111111111111111111111111111111111111111111111111111111111111111111111111111111111111111111111111111111111111111111111111111111111
