NO textures/no.xpm

WE textures/we.xpm


EA textures/ea.xpm


SO textures/so.xpm


F 255,000,000



C 000,000,255



1111111111111111111111111111111
1000000010011000111011100000001
1011111010111001100101101111101
1010001010100001101101101000101
1010001011011110110110001000101
1010001010101000110001101000101
1011111011000100100110101111101
1000000010101010101010100000001
1111111111001110011011111111111
1011000000010000000111011010001
1100010100100010010001010010011
1110110010101110000010110010111
1000010101111010110101000101101
1000001010001100011110100111101
1100110111100011001011100000001
1101001010101010010000001010101
1100011110100110001001110010101
1010100000110111N11100011101111
1001111110111111010001111010011
1000001010000000011001111001101
1000001110011101001001101100111
1001100010000101110110000000011
1111111110111101111010111001111
1000000000011101010000101001111
1011111010101001000100111011001
1010001010100101011000000001101
1010001010101100010011011111101
1010001011011011000110010010001
1011111011000100111111100100101
1000000000000010001000101011111
1111111111111111111111111111111
