NO textures/no.xpm

WE textures/we.xpm


EA textures/ea.xpm


SO textures/so.xpm


F 109,109,109


C 135,206,235


111111111111111111111
100111110000000001001
100000000000000000001
100001110000000000001
1000000000W0000000001
100000000000000000001
100000000111000000001
100000000000000000001
111111111111111111111