NO ./textures/N.xpm
WE ./textures/W.xpm
EA ./textures/E.xpm
SO ./textures/S.xpm
   
C 244,45,44
F -1,145,143

1111111111111111111111111            
1000000000110000000000001
1011000001110000001000001                         
10010000000000000000010011111111111       
11111111101100000111E00000000000001
100000000011000001110111110111111111111
11110111111111011100000010001
11110111111111011101010010001
1100000011010000000010111000011111111111
1100000011010000000010111000000000000001
1000100000000000000000011000011111111111
10000000000000001101010010001
1100000111010101111101111000111
11110111 1110101 101111010001
11111111 1111111 111111111111
