NO textures/no.xpm

WE textures/we.xpm


EA textures/ea.xpm


SO textures/so.xpm


F 255,255,255


C 255,0,0



1111111111111111111111111111111111111111
1000000000000000000000000000000000000001
1000001111111111000000000000000000000001
1000000000000000000000000000000000000001
1000000000000000000000000000000000000001
1000000000000000000000000000000000000001
1000001111111111111111111111110000000001
1000001111100000000000000000000000000001
1000001111100000000000000000000000000001
1000001111100000000000000000000000000001
1000001111100000000000000000000000000001
1000001111100000000000000000000000000001
1000001111111111111111111111100000000001
1000000000S00000000000000000000000000001
1000000000000000000000000000000000000001
1000000000000000000000000000000000000001
1000001111111111000000000000000000000001
1000000000000000000000000000000000000001
1000000000000000000000000000000000000001
1111111111111111111111111111111111111111